R 100  180
NO textures/wall_1.xpm
SO textures/wall_2.xpm
WE textures/wall_3.xpm
EA textures/wall_4.xpm
S textures/lion.xpm


F 184,113,39
C 51,198,227

111111111111111111111111111111
100000000000001100000000000001
100000000000001100000000000001
100000000000001100000000000001
100020000000000000000000000001
100000000000000000000020000001
100000000000000000000000000001
100000000000000000000000000001
100000000000000000000000000001
100002000000000000000200000001
100000000000000000000000000001
100000000000000200000000000001
111111111111111111111111111111