R      600  500
NO textures/wall_1.xpm
SO textures/wall_2.xpm
WE textures/wall_3.xpm
EA textures/wall_4.xpm
S textures/lion.xpm
F 184,113,39
C 51,198,227

101111
100001
102001
102001
111117
